EA ./textures/04.xpm
NO      ./textures/02.xpm
WE  ./textures/03.xpm
R  1920 1080
SO    ./textures/0 1.xpm

S  ./textures/sp.xpm
F 200,90,82
C 210,200,200

        1111111111111111111111111
        1000000000110000000000001
        1011000001110002000000001
        1001000000000000000020001
111111111011000001100000002000001
100000000011000001100111111111111
11110111111111011100000010001
11110111111111011101010010001
11000000110101011100000010001
10000200000000000000200010201
10000000000000001101010000001 
11000001110101011111010000N0111
11110111 1110101 101111010201
11111111 1111111 111111111111
